CO1 Mark,CO2 Mark,CO3 Mark,CO4 Mark,CO5 Mark,Total Mark
18,19,17,18,19,91
19,19,20,18,20,96
18,17,19,16,18,88
20,18,20,19,20,97
20,20,19,20,20,99
15,15,20,20,19,89
20,18,20,20,19,97
19,16,19,20,19,93
19,18,20,17,20,94
20,20,19,20,18,97
12,16,18,20,19,85
14,15,19,15,13,76
20,16,16,20,20,92
13,20,16,20,9,78
6,17,15,20,12,70
10,14,19,13,19,75
10,13,20,10,17,70
13,15,10,19,13,70
